1111111111111111111111111
1000000000000000000000001
100000000000C000000000001
10000000000CCC00000000001
1000000000000000000000001
1P0000000001E100000000001
1111111111111111111111111
