11111111111111111111111111111111
10000000000000000000000000000001
10C00C00C0000000000000C00C000001
10C00C00C0000000000000C00C000001
10CCCCCCC0000000000000C00C00Y111
10C00C00C0000000000000C00C000CE1
10C00C00C0000000000000C00C00Y111
10000000000000000000000000000001
10000000000000000000000000000001
10000000000000000000000000000001
1P000000000000000000000000000001
11111111111111111111111111111111
