1111111111111111111111111111111111111111
1000000000000000000010000000000000000001
10CCCCCCCC000CCCCC0Y1CCC000CC00CC00CCC01
10000CC00000CCCCCCC11CCCC00CC00CC0CCC001
10000CC00000CC000CC00CC0CC0CC00CCCCC0001
10000CC0000CC00000CC0CC0CC0CC00CCCC00001
10000CC0000CCCCCCCCC0CC0CC0CC00CCCCC0001
10000CC0000CC00000CC0CC00CCCC00CC0CCC001
10000CC0000CC00000CC0CC000CCC00CC00CCC01
1000000000000000000000000000000000000001
1000000000000000000000000000000000000001
10000010000100000000000000000000P0000001
1000011000010000000000000000000000000001
10000Y1000010000000001111111000000000001
1000011000010000000000000000000000000001
1000001000010000000000000000000000000001
1001111000011110000000000000010000000001
10000000000000001010000000000Y1000000001
10000000000000001E1000000000000000000001
1111111111111111111111111111111111111111
