111111111111111111111111111111111111
1ECCCC1000000000000000000000000000C1
11111C100000000000000000000000000C01
10001C10000000000000000000000000C001
1000CC1000000000000000000000000CCCC1
100011100000000000000000000000C00001
10000000000000000000000000000CCCCCC1
100000000000000000P00000000000C00001
1000000000000000000000000000000CCCC1
10000000000000000000000000000000C001
100000000000000000000000000000000C01
1000000000000000000000000000000000C1
111111111111111111111111111111111111
